NO resources/textures/brickov.xpm
SO resources/textures/brickov.xpm
WE resources/textures/brickov.xpm
EA resources/textures/brickov.xpm

C 252,253,255
F 252,253,255

111111 111
1000000001
1000N00001
1000000001
1111111111
