NO ./resources/textures/n.xpm
SO ./resources/textures/s.xpm
WE ./resources/textures/w.xpm
EA ./resources/textures/e.xpm

F 255,30,100
C 19,22,61

1111111111111111111111111111111111111111111111111111111111111111
1000000000000000000000000000000000000000000000000000000000000001
1000000000000000000000000000000000000000000000000111111110000001
1000000000011111111111111111111111100000000000000100000010000001
1000000000010000000000000000000000111111111111111100000011110001
1000000000011111111111000000000000000000000000000000000000010001
1000000000000000000001000111111111111000000001111111111110010001
1000001111111111110001000111111111111000000001111111111110010001
1000001000000000010001000011111111111100000011111111111100010001
1000001000000000010001000001111111111110000111111111111000010001
1000001000011100010001000001111111111110000111111111111000010001
1000001000110100010000000001111111111110000111111111111000010001
1000001000100111110000000011111111111100000011111111111100000001
1000001000100000000000001111111111110000000001111111111110000001
1000001000100000000000111111111111000000000000111111111111000001
1000001000111111111101111111111110000000000000011111111111100001
1000001000000000000000000000000000000000000000000000000000000001
1000001000111111111000000111111111111000000000001111111111110001
100000100000000000000E000000000000000000000000000000000000010001
1000001000000000000000000000000000000000000000000000000000010001
1000001000011111000111110000111110001111100011111000111110010001
1000001000010001000100010000100010001000100010001000100010010001
1000001000010001000100010000100010001000100010001000100010010001
1000001000010001000100010000100010001000100010001000100010010001
1000001000010001000100010000100010001000100010001000100010010001
1000001000010001000100010000100010001000100010001000100010010001
1000001000010001000100010000100010001000100010001000100010010001
1000001000010001000100010000100010001000100010001000100010010001
1000001000010001000100010000100010001000100010001000100010010001
1000001000011111000111110000111110001111100011111000111110010001
1000000000000000000000000000000000000000000000000000000000010001
1000000000111110000000000000000000000000000000000000000000010001
1000000000100010000000111111110001111111100000000000000000010001
1000000010000010000000100000000001000000100000000001111111110001
1000000011111110000000100000010001000000100000000000000000000001
1000000000000000000000100000010000000000100000000000000000000001
1000000000000000000000111111110001111111100000000000000000000001
1000000000000000000000000000000000000000000000000000000000000001
1111111111111111111111111111111111111111111111111111111111111111
