F 255,30,100
C 19,22,61








EA ./resources/textures/e.xpm
NO ./resources/textures/n.xpm
SO ./resources/textures/s.xpm
WE ./resources/textures/w.xpm


11111111111111111111
10000000000000010001
10000000000000010001
10000000000000000001
10001101010101000001
10000001000000000001
10000001000000000001
10000000000001000001
10000000W00000000001
10000000000010000001
10000000000010000001
10000000000010000001
11111111111111111111
